R 800 600

NO ./path_to_the_north_texture
SO ./path_to_the_south_texture
WE ./path_to_the_west_texture
EA ./path_to_the_east_texture

S ./path_to_the_sprite_texture
F 220,100,0
C 225,30,0

  11111111111111111111111
11100000001100000110000111
11000000000000011111000001
10000000000000000000000001
111111100000000000N000111
11111000000000000001111
    1111111111111111111111