R 1000 800

NO ./textures/north.xpm  
SO ./textures/south.xpm

F 220,100,0

C 225,30,0

WE ./textures/west.xpm  

EA ./textures/east.xpm
S ./textures/pillar.xpm

  11111111111111111111111
11100000001100000110000111
11000000000000011111000001
10000000000200000000000001
111111100000000N000000111
11111000000000000001111
    1111111110111111111111
    1111111110111111111111